1111111111
1P100000E1
1111111111
1000010001
1C01111111
1000000C01
1111111111
