11111111
10PC1111
10C0E1C1
11111111
