11111111
100C1111
10P0E111
11111111
