11111111111111111111
1P0000000100000000C1
10111111010111111101
10100000000010000001
10101111111010111101
10000000001000100001
11111011101110101111
1000C010000000100001
10111110111111111101
100000000000000000C1
10111011111101110101
10100010000001000101
10111110111111011101
1C0000000000000000E1
11111111111111111111
