1111111111
1P000000E1
1011111101
1000010001
1001110001
1000000001
1111111111
