1111111111
1P00000011
1011111101
1000010001
1C01110001
1000000C01
1111111111
