1111111111
10000000E1
1011111101
1000010001
1C01110001
1000000C01
1111111111
