11111
10P01
1C001
100E1
11111
